1 13 31
###############################
#p     s* *  1 * 2  *  * * *  #
# # # #*# # #*#*# # # #*#*#*# #
#  x*     b**  *      *   * * #
# # # # # #*# # #*#*# # # # #*#
#f          **  *  *          #
# # # # # # # # # #*# #*# # # #
#*  *      *  *      *        #
# # # # #*# # # #*#*# # # # # #
#*    **  *       *           #
# #*# # # # # # #*# # # # # # #
#           *   *  *          #
###############################
