3 13 31
###############################
#p        *2*  ** 1* * *     *#
# # # # #*# # #*# # # # # #*# #
#s     * *f* **      *    **  #
# #*# # # # #3# #b#1# # # # #*#
#          *     **      *  **#
# # #*# # # # # #*#*#*#*# # # #
#   * x*       *   * ** *     #
# # # # #*# # # # # # #*# #*# #
#   ****         *1           #
# # # # # # # # # #*# # # # #*#
#  ** *   *                   #
###############################